; Ízi
#####
#@$.#
#####

; Kicsit hardör
########
#   @  #
# $   .#
########

; Ez könnyű lett...
#####
#@  #
# $.#
#####

; Sanyi
######
#@ #.#
#  $ #
#.$  #
######

; penc
#######
#@#.  #
# .$$ #
#   $ #
# $.#.#
#######

